Afrikaans: Michael Bütow, peter hanox
Albanian: arianit, Nick
Arabic: Ahmed A Khalil, Bassem Abdullah, Mohamed El-Kamony, Mosa AAA, Rudy Zeinoun, salem alajmi, shady abdo
Armenian: Suren Karapetyan
Basque: 3arrano
Bulgarian: Boian Valentinov Todorov, ceco, Nas Van Chev, Petra Milanova, Stoyan P. Bonkov
Catalan: Alex Guardiet, Diego González Lorenzo, Jonathan atkinson
Chinese (Simplified): Eric, Li Jiaxiang, Qiang Yuan, ricky, Tang Kai Yiu, thesues, xueyong, Yang Hong, ZhouMo
Chinese (Traditional): abbie, Abel Cheung, alex lee, cheng-han chiang, Cheng Ka Ho, Hin, Jamie, kourge, ming chang, something else, Tang Kai Yiu, Tony Tsang, Vincent M, wongpoyee, Zeus Cho, Zhu He
Croatian: Anto Anic, djryback, ZeroKillaz
Czech: Grossmann RAdek, Jiri Doubravsky, Marek Kobera, Martin Ambrož, Peter Stelcer, Vlastimil Skacel, Vlastislav Weiner
Danish: Christian Wichmann Moesgaard, kenneth krabat, Malthe Sunesen, Malthe Sunesen, Mark Rosenstand, Tino Didriksen
Dutch: alexanderpas, Carlo Martens, David Visser, David Visser, Dennis Veenstra, eric, Frank Eising, Frank Jacobs, Fred Brouwer, ger lanslots, Gijsbert Ooms, Jan Schut, Koen Vits, Levi Roelofsma, manuel, Martijn van Gene, Michel Pauwels, M.J.Louwe, noah, Patrick Catthoor, Paul Kassebaum, Petra van Assen, Roy Mietes, sofie clissen, Tijmen, Wolf Hijlkema
Esperanto: Gabriel Beecham
Estonian: Aleksander Härmas, Priit Laes
Finnish: Aaro Juntunen, ett pok, Juha Heinänen, Matti Tuomola, Matti Viljanen, Ni Mer, Tiia Kärkkäinen, Ville Virta
French: Ariel G, Christophe Riviere, David Maciejak, Edouard Biton, finder, Guilhem Bailly, Hamdouch deera, jean vignoli, Jürgen Köster, ludo, Ludovic Mirlatif, Nicolas, Philippe Lamalice, Raphael Chabert, samuel boucher, sarah, Sébastien Mouren, Trollnumber1
Irish: Gabriel Beecham, Gareth Peoples
German: Amun Abdulla, Benjamin Schröder, Bjoern Schlaak, Buschbeck, Carl-Marcus Pellmann, Chris Anders, Christian Specht, Claus Radloff, Darko Bugarin, emre tas, Georg Schuster, Gerald Schaftner, hein blöd, jan, leopold pichlmüller, marcel barion, Martin hoffman, Michael Krämer, Michael Tänzer, Milan Geh, Nando Filigrasso, oliver boht, Petra Wittkopf, riraraffi, Roman Gasser, romy ripperger, rosati, sabit iftari, Sebastian Mosch, S. Hizo, Thomas Gruß, Thomas Magnet, Thomas Sandner, Wilhelm Hahn
Greek: Chris Anastasopoulos, Fotis and Chris, Leah Petra, Manouk Vartan Manoukian, Nikolaos Gryspolakis
Hebrew: Avi Erel, Elhanan Ben-Yishay, eran raderman, YossiZR
Hungarian: Attila Selmeci, Bíró Mariann, esoxxx, Javori Gabor, Kovács Rajmund, laszlo Pataki, les Vorosmarthy, Peter Takacs, Tamas Szanto, tr, Vincze Márton
Italian: alessandra, Alessandro Aglietti, ciccio orso, ennio, Fabrizio Salieri, Federico D'Ambrosio, franco, Fulvio, gian bernetti, Giasone Argo, giuseppe marchetta, Hiram Oswaldo Pena Porras, Marco Solimando, massimo maccolini, matteo, max, max, Monty, motard, mp, napoli, paul rollin, serdean, stefano, TheBoss, valery, Valter Ratti, Vincenzo Reale
Japanese: Knagi, Masataka Nakamura, Megan E, mitcho (Michael 芳貴 Erlewine), tomoko kanda, Yasushi Iwata
Georgian: Aiet Kolkhi
Korean: Kim, YungGeun, Son, Kyeong-uk, Spade, Steve K Lee, Sung Jae, Cho
Lithuanian: Kestas Ermanas
Malayalam: Mannar Mathai
Malay: Emirin Mohamed Kasah
Norwegian Bokmal: Arnt Runar Tjøstheim, Guri Norman, Philipp Aaholm, tormod
Norwegian Nynorsk: Audun Einangen, Knut Erik
Polish: Adam Andrzejewski, Bartek Wisniewski, Citrus, crashload, jerzy czaja -szwajcer, Jozef Rozmus, Konrad Mantorski, Marek Adam, Markus Valen, Michal Durys, olek lorenc, Piotr Drąg, Piotr Gospodarek, Szymon Adamczyk, Tomasz Kłosiński
Portuguese: Carlos, João Pedro Pais, Luis Antonio Domingues, sepulveda, Tiago Dias Bugarin, Tiago Dias Bugarin, Tiago Filipe Gonçalves Afonso Sousa da Silva, Vandrei Cerqueira
Brazillian Portuguese: Augusto Uehara, Carlos Werner, Édipo Antunes, Gustavo Bruno, juvas men, maycon souza, Natanael Pinho, Paulo Anselmo de Oliveira, Renan Valente Rangel, Renato, Tiago Dias Bugarin, Vandrei Cerqueira, wanteildo antunes ayres de lima
Romanian: izabela, Lupoiu Victor Alexandru, Manea Costin, peter pann, Radu Ciuca, Radu Costel-Adrian
Russian: Andrey Kuznetsov, Andrey, Dmitry Bogatykh, Dmitry Bogatykh, Dmitry Morozov, Efremov, Lozovoy Vasiliy, Pavel Maryanov, Pavel Vlasov, Shangin Alexander, Vika, Vladislav Zavyalov, Yuri
Slovak: Andrej Palička, fork27, jakub siska, jefko, savas, Tibor Vrskovy
Slovenian: A.V., Dušan Mulac, Ervin, Jure Repinc, Jure Repinc
Spanish: alejandro ariel mac-kay, Ana Lago, arturobibriesca, bernardita errazuriz, Carlos Lozano, Christian Jaramillo, claudia, D4nny, Damian Antonio Fenocchio, Daniel Gasco Rodriguez, elaine de lima, Francisco, Gustavo Attanasio, gustavo chianese, Jazmin Velazquez Lopez, Jovani, juan Perez, juliana, kesar, Lucas Lux, monica, Néstor Peralta, Nicanor, Pablo Canale, pazuzu, rai
Mexican Spanish: Alfonso Labastida Zamora, arturobibriesca, Cesar Armando Rodriguez, Daniel Gasco Rodriguez, Francisco, Hugo, Jose Guadalue Alvarez Cordoba, Jovani, juliana, Pablo Canale, zukaboy_gdl
Swedish: Alexander Berglund, Christoffer Söderholm, David Vilhelmsson Ronad, Essi, Gabriela Soto Mora, Gustav Tiger, Henrik, Jonas Hedberg, Joop van der Lei, Markus, Martin Svensson, mattias söderberg, Stefan, T. N., William Noritis
Telugu: Madan Meka
Thai: Supiti Buranawatanachoke, Yongyut Booncherd
tlhIngan-Hol: chris curran
Turkish: Elnur Mehdi, Erhan Abay, Eryen Akgün, Levent, m.eminogullari, Oguzhan Yuzabasıoglu, Özcan Arslan, Ozgur Basar, Veysel Harun Sahin, z
Ukrainian: Denis Mostovlyuk, Yakov Glumov
Vietnamese: Clytie Siddall
Welsh: Tony Sciubba
